11111111111111111111
10000000000000000001
10000000111000000001
10000001000100000001
100C0010000010000001
10CCC0C00P0010000001
100C00100000100C0001
10000001000100CCC001
1111111111100CCCCC01
1C0000C0000000011111
1C1111111110CC01CCC1
1C0000000C100001C1C1
11111111101111110101
111111111C00000C01E1
11111111111111111111
