11111111111111111111
10000000000000000001
10XXX00011100X0X0X01
10000001000100000001
100C0010000010X0X001
10CCC0C00P0010000001
100C001000001XXCXXX1
10000001000100CCC001
1111111111100CCCCC01
1C0000C000000XX11111
1CX1111111X0CC01CCC1
1C0000000CX00001CXC1
11111111X01111110X01
11111111XC00000C0XE1
11111111111111111111
