1111111111
10P0000C01
1111100001
1C00000C01
1C11111111
1000C000E1
1111111111
