11111111111111111111111111111
1111111111111PEC1111111111111
