11111111111111111111111
10000000P0000000CC000C1
100000000000000CC000001
11111111111111111111111
