00000000000000000000000000
1000000000000000000000P001
100000000000000000E000C001
11111111111111111111111111
