1111111111111111111111
1000000000000000000001
1000P00C000E0000000001
1000000000000000000001
