11111111111111111
10000000234500001
11111111111111111
