11111111111111111111
10000000000000000000
100000000000000CPE00
11111111111111111111
