1111111111111111111
1000000000000000001
100000E0000C0000C01
1111111111111111111
