11111111111111111
100P0E0C234500001
11111111111111111
