111111111011111111111
00000000000000E000001
10000000000000CP00000
111111111110111111111
