111111111111111111111111111111
100000000000000000000000000001
1111111111111J1111111111111111
