11111111111111111111111
1000000000000000000001
100000000000011111111
10000000000001
100000000000001
11111111111111111111
